sea_floor-01
Level_1-02
nil
nil
Level_1-04
2 0 2 1 0
2 0 0 1 2
2 1 2 1 1
2 1 6 1 1
2 3 2 1 0
2 3 6 1 0
2 0 7 1 2
2 0 6 1 0
2 4 0 0 0
2 5 0 0 0
2 6 0 0 0
2 7 0 0 0
2 8 0 0 1
2 8 1 0 2
2 8 2 0 2
2 8 3 0 2
2 8 4 0 2
2 8 5 0 2
2 8 6 0 2
2 8 7 0 2
2 8 8 0 1
2 7 8 0 2
2 6 8 0 2
2 5 8 0 2
2 4 8 0 2
2 3 8 0 2
2 2 8 0 2
2 1 8 0 2
2 4 2 0 0
2 5 2 0 1
2 5 3 0 0
2 5 4 0 0
2 5 5 0 0
2 5 6 0 0
5 1 7
3 4 3
3 3 3
3 4 4
1 6 1
1 7 2
1 6 3
1 7 4
1 6 5
1 7 6