sea_floor-01
nil
Level_1-02
nil
nil
2 0 0 0 2
2 1 0 0 2
2 2 0 0 2
2 3 0 0 2
2 4 0 0 2
2 5 0 0 2
2 6 0 0 2
2 7 0 0 2
2 8 0 0 2
2 0 8 0 1
2 1 8 0 0
2 2 8 0 0
2 3 8 0 0
2 4 8 0 0
2 5 8 0 0
2 6 8 0 0
2 7 8 0 0
2 8 8 0 1
2 0 1 0 2
2 0 2 0 2
2 0 3 0 2
2 0 4 0 2
2 0 5 0 2
2 0 6 0 2
2 0 7 0 2
2 8 3 0 0
2 8 4 0 0
2 8 5 0 0
2 8 6 0 0
2 8 7 0 0
2 4 1 0 0
2 4 2 0 0
2 4 3 0 0
2 4 4 0 0
2 4 5 0 0
4 1 1
1 5 1
1 7 2
1 5 3
1 7 4
1 5 5
1 7 6
1 5 7