temple_floor-01
nil
Level_1-03
nil
nil
2 8 0 1 2
2 8 2 1 0
2 8 6 1 0
2 8 7 1 2
2 1 0 1 1
2 3 0 1 1
2 5 0 1 1
2 1 8 1 1
2 3 8 1 1
2 5 8 1 1
2 7 0 1 0
2 7 8 1 0
2 0 0 1 2
2 0 2 1 2
2 0 4 1 2
2 0 6 1 2
2 0 8 1 0
2 2 2 1 0
2 6 2 1 0
2 6 6 1 0
2 2 6 1 0